               
       **      
     **  **    
   **      **  
 **  ******  **
       **      
  ************ 
      ****     
    ** ** **   
  **   **   ** 
               
   **     **   
   **    **    
 ****** *******
   **   **   **
  ****  **   **
 * ** * *******
   **   **   **
   **   **   **
   **   *******
               
      **       
  *************
  ** ********* 
  **   **  **  
  ** **********
  **     **  * 
  **   * **    
 **     ***    
 *       **    
               
 ***********   
 **        **  
 **         ** 
 **        **  
 ***********   
 **         ** 
 **          **
 **         ** 
 ************  
               
 **          **
 **          **
 **          **
 **          **
 **          **
 **          **
 **          **
  **        ** 
   **********  
               
 ************  
 **         ** 
 **          **
 **         ** 
 ************  
 **  **        
 **    **      
 **      ***   
 **        ****
               
 ****        **
 ** **       **
 **  **      **
 **   **     **
 **    **    **
 **     **   **
 **      **  **
 **       ** **
 **        ****
               
 **************
 **           *
 **            
 **           *
 **************
 **           *
 **            
 **           *
 **************
               
 **          **
   **      **  
     **  **    
       **      
       **      
       **      
       **      
       **      
       **      